+binarni_element
Li:litijev:1
Na:natrijev:1
K:kalijev:1
Rb:rubidijev:1
Cs:cezijev:1
Mg:magnezijev:2
Ca:kalcijev:2
Sr:stroncijev:2
Ba:barijev:2
Al:aluminijev:3
Si:silicijev:4
N:nitrid:-3
P:fosfid:-3
O:oksid:-2
S:sulfid:-2
F:fluorid:-1
Cl:klorid:-1
Br:bromid:-1
I:jodid:-1
+binarna_izjema
bromov fluorid=bromov(I) fluorid:BrF
bromov trifluorid=bromov(III) fluorid:BrF3
bromov pentafluorid=bromov(V) fluorid:BrF5
dibromov pentaoksid=bromov(V) oksid:Br2O5
bromov dioksid=bromov(II) oksid:BrO2
klorov fluorid=klorov(I) fluorid:ClF
klorov trifluorid=klorov(III) fluorid:ClF3
klorov pentafluorid=klorov(V) fluorid:ClF5
diklorov oksid=klorov(I) oksid:Cl2O
klorov dioksid=klorov(IV) oksid:ClO2
klorov oksid=klorov(II) oksid:ClO
diklorov heptaoksid=klorov(VII) oksid:Cl2O7
jodov fluorid=jodov(I) fluorid:IF
jodov trifluorid=jodov(III) fluorid:IF3
jodov pentafluorid=jodov(V) fluorid:IF5
jodov heptafluorid=jodov(VII) fluorid:IF7
jodov bromid=jodov(I) bromid:IBr
jodov klorid=jodov(I) klorid:ICl
dijodov pentaoksid=jodov(V) oksid:I2O5
didušikov oksid=dušikov(I) oksid:N2O
dušikov oksid=dušikov(II) oksid:NO
dušikov dioksid=dušikov(IV) oksid:NO2
didušikov trioksid=dušikov(III) oksid:N2O3
didušikov pentaoksid=dušikov(V) oksid:N2O5
dušikov trifluorid=dušikov(III) fluorid:NF3
dušikov triklorid=dušikov(III) klorid:NCl3
dušikov tribromid=dušikov(III) bromid:NBr3
dušikov trijodid=dušikov(III) jodid:NI3
fosforjev trijodid=fosforjev(III) jodid:PI3
fosforjev tribromid=fosforjev(III) bromid:PBr3
fosforjev pentabromid=fosforjev(V) bromid:PBr5
fosforjev triklorid=fosforjev(III) klorid:PCl3
fosforjev pentaklorid=fosforjev(V) klorid:PCl5
žveplov dioksid=žveplov(IV) oksid:SO2
žveplov trioksid=žveplov(VI) oksid:SO3
žveplov difluorid=žveplov(II) fluorid:SF2
žveplov tetrafluorid=žveplov(IV) fluorid:SF4
žveplov heksafluorid=žveplov(VI) fluorid:SF6
žveplov diklorid=žveplov(II) klorid:SCl2
ksenonov difluorid=ksenonov(II) fluorid:XeF2
ksenonov tetrafluorid=ksenonov(IV) fluorid:XeF4
ksenonov heksafluorid=ksenonov(VI) fluorid:XeF6
ksenonov trioksid=ksenonov(VI) oksid:XeO3
ksenonov tetraoksid=ksenonov(VIII) oksid:XeO4
srebrov(I) jodid:AgI
srebrov(I) bromid:AgBr
srebrov(I) klorid:AgCl
srebrov(I) cianid:AgCN
srebrov oksid=srebrov(I) oksid:Ag2O
srebrov sulfid=srebrov(I) sulfid:Ag2S
arzenov dijodid=arzenov(III) jodid:AsI3
arzenov diklorid=arzenov(III) klorid:AsCl3
diarzenov trioksid=arzenov(III) oksid:As2O3
diarzenov trisulfid=arzenov(III) sulfid:As2S3
diarzenov tritelurid=arzenov(III) telurid:As2Te3
zlatov(I) jodid:AuI
bizmutov dijodid=bizmutov(III) jodid:BiI3
bizmutov dibromid=bizmutov(III) bromid:BiBr3
bizmutov diklorid=bizmutov(III) klorid:BiCl3
bizmutov difluorid=bizmutov(III) fluorid:BiF3
dibizmutov trioksid=bizmutov(III) oksid:Bi2O3
dibizmutov triselenid=bizmutov(III) selenid:Bi2Se3
dibizmutov trisulfid=bizmutov(III) sulfid:Bi2S3
dibizmutov tritelurid=bizmutov(III) telurid:Bi2Te3
kadmijev dibromid=kadmijev(II) bromid:CdBr2
kadmijev diklorid=kadmijev(II) klorid:CdCl2
kadmijev difluorid=kadmijev(II) fluorid:CdF2
kadmijev dijodid=kadmijev(II) jodid:CdI2
kadmijev(II) oksid:CdO
trikadmijev difosfid=kadmijev(II) fosfid:Cd3P2
kadmijev(II) selenid:CdSe
kadmijev(II) sulfid:CdS
kadmijev(II) telurid:CdTe
kobaltov dijodid=kobaltov(II) jodid:CoI2
kobaltov dibromid=kobaltov(II) bromid:CoBr2
kobaltov diklorid=kobaltov(II) klorid:CoCl2
kobaltov difluorid=kobaltov(II) fluorid:CoF2
kobaltov(II) oksid:CoO
kobaltov(II) selenid:CoSe
kobaltov(II) sulfid:CoS
kromov dijodid=kromov(III) jodid:CrI3
kromov diklorid=kromov(III) klorid:CrCl3
kromov difluorid=kromov(III) fluorid:CrF3
dikromov trioksid=kromov(III) oksid:Cr2O3
dikromov trisulfid=kromov(III) sulfid:Cr2S3
dikromov tritelurid=kromov(III) telurid:Cr2Te3
bakrov(I) bromid:CuBr
bakrov(I) klorid:CuCl
bakrov(I) cianid:CuCN
bakrov(I) jodid:CuI
bakrov nitrid=bakrov(I) nitrid:Cu3N
bakrov oksid=bakrov(I) oksid:Cu2O
bakrov selenid=bakrov(I) selenid:Cu2Se
bakrov sulfid=bakrov(I) sulfid:Cu2S
bakrov telurid=bakrov(I) telurid:Cu2Te
železov dijodid=železov(II) jodid:FeI2
železov dibromid=železov(II) bromid:FeBr2
železov diklorid=železov(II) klorid:FeCl2
železov difluorid=železov(II) fluorid:FeF2
železov(II) oksid:FeO
železov(II) selenid:FeSe
železov(II) sulfid:FeS
galijev dibromid=galijev(III) bromid:GaBr3
galijev diklorid=galijev(III) klorid:GaCl3
galijev difluorid=galijev(III) fluorid:GaF3
galijev(III) nitrid:GaN
digalijev trioksid=galijev(III) oksid:Ga2O3
digalijev trisulfid=galijev(III) sulfid:Ga2S3
germanijev dijodid=germanijev jodid=germanijev(IV) jodid=germanijev jodid:GeI4
germanijev diklorid=germanijev klorid=germanijev(IV) klorid=germanijev klorid:GeCl4
germanijev dioksid=germanijev oksid=germanijev(IV) oksid=germanijev oksid:GeO2
hafnijev dijodid=hafnijev(IV) jodid:HfI4
hafnijev dibromid=hafnijev(IV) bromid:HfBr4
hafnijev diklorid=hafnijev(IV) klorid:HfCl4
hafnijev difluorid=hafnijev(IV) fluorid:HfF4
hafnijev dioksid=hafnijev(IV) oksid:HfO2
živosrebrov dijodid=živosrebrov(II) jodid:HgI2
živosrebrov dibromid=živosrebrov(II) bromid:HgBr2
živosrebrov diklorid=živosrebrov(II) klorid:HgCl2
živosrebrov difluorid=živosrebrov(II) fluorid:HgF2
živosrebrov(II) oksid:HgO
živosrebrov(II) selenid:HgSe
živosrebrov(II) telurid:HgTe
živosrebrov(II) sulfid:HgS
indijev dijodid=indijev(III) jodid:InI3
indijev dibromid=indijev(III) bromid:InBr3
indijev diklorid=indijev(III) klorid:InCl3
indijev difluorid=indijev(III) fluorid:InF3
indijev(III) fosfid:InP
diindijev triselenid=indijev(III) selenid:In2Se3
diindijev trisulfid=indijev(III) sulfid:In2S3
diindijev trioksid=indijev(III) oksid:In2O3
iridijev dibromid=iridijev(IV) bromid:IrBr4
iridijev diklorid=iridijev(IV) klorid:IrCl4
iridijev dijodid=iridijev(IV) jodid:IrI4
iridijev dioksid=iridijev(IV) oksid:IrO2
lantanov dibromid=lantanov(III) bromid:LaBr3
lantanov diklorid=lantanov(III) klorid:LaCl3
lantanov difluorid=lantanov(III) fluorid:LaF3
lantanov dijodid=lantanov(III) jodid:LaI3
lantanov(III) nitrid:LaN
dilantanov trioksid=lantanov(III) oksid:La2O3
manganov dijodid=manganov(II) jodid:MnI2
manganov dibromid=manganov(II) bromid:MnBr2
manganov diklorid=manganov(II) klorid:MnCl2
manganov difluorid=manganov(II) fluorid:MnF2
manganov(II) oksid:MnO
manganov(II) selenid:MnSe
manganov(II) sulfid:MnS
molibdenov dioksid=molibdenov(IV) oksid:MoO2
molibdenov difluorid=molibdenov(IV) fluorid:MoF4
molibdenov diselenid=molibdenov(IV) selenid:MoSe2
molibdenov disulfid=molibdenov(IV) sulfid:MoS2
niobijev dijodid=niobijev(V) jodid:NbI5
niobijev diklorid=niobijev(V) klorid:NbCl5
niobijev difluorid=niobijev(V) fluorid:NbF5
diniobijev pentaoksid=niobijev(V) oksid:Nb2O5
nikljev dijodid=nikljev(II) jodid:NiI2
nikljev dibromid=nikljev(II) bromid:NiBr2
nikljev(II) sulfid:NiS
nikljev(II) telurid:NiTe
osmijev dioksid=osmijev(IV) oksid:OsO2
svinčev dijodid=svinčev(II) jodid:PbI2
svinčev dibromid=svinčev(II) bromid:PbBr2
svinčev diklorid=svinčev(II) klorid:PbCl2
svinčev difluorid=svinčev(II) fluorid:PbF2
svinčev(II) oksid:PbO
svinčev(II) selenid:PbSe
svinčev(II) telurid:PbTe
paladijev dibromid=paladijev(II) bromid:PdBr2
paladijev diklorid=paladijev(II) klorid:PdCl2
paladijev dicianid=paladijev(II) cianid:Pd(CN)2
paladijev dijodid=paladijev(II) jodid:PdI2
paladijev(II) oksid:PdO
paladijev(II) sulfid:PdS
platinov dibromid=platinov(IV) bromid:PtBr4
platinov diklorid=platinov(IV) klorid:PtCl4
platinov dijodid=platinov(IV) jodid:PtI4
platinov dioksid=platinov(IV) oksid:PtO2
platinov disulfid=platinov(IV) sulfid:PtS2
rodijev diklorid=rodijev(III) klorid:RhCl3
rodijev dijodid=rodijev(III) jodid:RhI3
rutenijev dibromid=rutenijev(III) bromid:RuBr3
rutenijev diklorid=rutenijev(III) klorid:RuCl3
rutenijev dijodid=rutenijev(III) jodid:RuI3
antimonov dijodid=antimonov(III) jodid:SbI3
antimonov dibromid=antimonov(III) bromid:SbBr3
antimonov diklorid=antimonov(III) klorid:SbCl3
antimonov difluorid=antimonov(III) fluorid:SbF3
diantimonov trioksid=antimonov(III) oksid:Sb2O3
diantimonov triselenid=antimonov(III) selenid:Sb2Se3
diantimonov trisulfid=antimonov(III) sulfid:Sb2S3
diantimonov tritelurid=antimonov(III) telurid:Sb2Te3
skandijev diklorid=skandijev(III) klorid:ScCl3
skandijev difluorid=skandijev(III) fluorid:ScF3
skandijev dijodid=skandijev(III) jodid:ScI3
diskandijev trioksid=skandijev(III) oksid:Sc2O3
samarijev dijodid=samarijev(II) jodid:SmI2
kositrov dijodid=kositrov(II) jodid:SnI2
kositrov dibromid=kositrov(II) bromid:SnBr2
kositrov diklorid=kositrov(II) klorid:SnCl2
kositrov(II) oksid:SnO
kositrov difluorid=kositrov(II) fluorid:SnF2
kositrov(II) sulfid:SnS
kositrov(II) telurid:SnTe
talijev dijodid=talijev(V) jodid:TaI5
talijev dibromid=talijev(V) bromid:TaBr5
talijev diklorid=talijev(V) klorid:TaCl5
talijev difluorid=talijev(V) fluorid:TaF5
ditalijev pentaoksid=talijev(V) oksid:Ta2O5
terbijev dijodid=terbijev(III) jodid:TbI3
torijev dijodid=torijev(IV) jodid:ThI4
talijev(I) bromid:TlBr
talijev(I) klorid:TlCl
talijev(I) fluorid:TlF
talijev(I) jodid:TlI
talijev selenid=talijev(I) selenid:Tl2Se
talijev telurid=talijev(I) telurid:Tl2Te
titanov dijodid=titanov(IV) jodid:TiI4
titanov dibromid=titanov(IV) bromid:TiBr4
titanov dioksid=titanov(IV) oksid:TiO2
titanov difluorid=titanov(IV) fluorid:TiF4
titanov disulfid=titanov(IV) sulfid:TiS2
uranov dijodid=uranov(III) jodid:UI3
vanadijev dijodid=vanadijev(III) jodid:VI3
vanadijev dibromid=vanadijev(III) bromid:VBr3
vanadijev diklorid=vanadijev(III) klorid:VCl3
vanadijev difluorid=vanadijev(III) fluorid:VF3
divanadijev trioksid=vanadijev(III) oksid:V2O3
volframov diklorid=volframov(VI) klorid:WCl6
volframov dioksid=volframov(VI) oksid:WO3
itrijev dibromid=itrijev(III) bromid:YBr3
itrijev diklorid=itrijev(III) klorid:YCl3
itrijev difluorid=itrijev(III) fluorid:YF3
itrijev dijodid=itrijev(III) jodid:YI3
diitrijev trioksid=itrijev(III) oksid:Y2O3
diitrijev trisulfid=itrijev(III) sulfid:Y2S3
iterbijev dibromid=iterbijev(III) bromid:YbBr3
iterbijev diklorid=iterbijev(III) klorid:YbCl3
iterbijev difluorid=iterbijev(III) fluorid:YbF3
diitrijev trioksid=itrijev(III) oksid:Y2O3
cinkov dibromid=cinkov(II) bromid:ZnBr2
cinkov diklorid=cinkov(II) klorid:ZnCl2
cinkov dicianid=cinkov(II) cianid:Zn(CN)2
cinkov difluorid=cinkov(II) fluorid:ZnF2
cinkov dijodid=cinkov(II) jodid:ZnI2
tricinkov dinitrid=cinkov(II) nitrid:Zn3N2
cinkov(II) oksid:ZnO
tricinkov difosfid=cinkov(II) fosfid:Zn3P2
cinkov(II) selenid:ZnSe
cinkov(II) telurid:ZnTe
cirkonijev dijodid=cirkonijev(IV) jodid:ZrI4
cirkonijev dibromid=cirkonijev(IV) bromid:ZrBr4
cirkonijev diklorid=cirkonijev(IV) klorid:ZrCl4
cirkonijev dioksid=cirkonijev(IV) oksid:ZrO2
cirkonijev difluorid=cirkonijev(IV) fluorid:ZrF4
cirkonijev ditelurid=cirkonijev(IV) telurid:ZrTe2
srebrov difluorid=srebrov(II) fluorid:AgF2
srebrov(II) oksid:AgO
diarzenov pentaoksid=arzenov(V) oksid:As2O5
diarzenov triselenid=arzenov(III) selenid:As2Se3
kobaltov difluorid=kobaltov(III) fluorid:CoF3
kobaltov disulfid=kobaltov(IV) sulfid:CoS2
kromov diklorid=kromov(II) klorid:CrCl2
kromov difluorid=kromov(II) fluorid:CrF2
kromov dioksid=kromov(VI) oksid:CrO3
bakrov dibromid=bakrov(II) bromid:CuBr2
bakrov diklorid=bakrov(II) klorid:CuCl2
bakrov difluorid=bakrov(II) fluorid:CuF2
bakrov(II) oksid:CuO
bakrov(II) selenid:CuSe
bakrov(II) sulfid:CuS
železov diklorid=železov(III) klorid:FeCl3
železov difluorid=železov(III) fluorid:FeF3
diželezov trioksid=železov(III) oksid:Fe2O3
galijev(II) telurid:GaTe
germnijev dijodid=germnijev(II) jodid:GeI2
germnijev(II) telurid:GeTe
hafnijev ditelurid=hafnijev(VIII) telurid:HfTe4
indijev(I) jodid:InI
indijev(I) klorid:InCl
indijev(I) bromid:InBr
iridijev dibromid=iridijev(III) bromid:IrBr3
iridijev diklorid=iridijev(III) klorid:IrCl3
manganov dioksid=manganov(IV) oksid:MnO2
manganov difluorid=manganov(III) fluorid:MnF3
manganov ditelurid=manganov(IV) telurid:MnTe2
molibdenov diklorid=molibdenov(III) klorid:MoCl3
molibdenov diklorid=molibdenov(V) klorid:MoCl5
molibdenov dioksid=molibdenov(VI) oksid:MoO3
niobijev(II) oksid:NbO
niobijev dioksid=niobijev(IV) oksid:NbO2
niobijev diselenid=niobijev(IV) selenid:NbSe2
osmijev dioksid=osmijev(VIII) oksid:OsO4
svinčev difluorid=svinčev(IV) fluorid:PbF4
svinčev dioksid=svinčev(IV) oksid:PbO2
platinov dibromid=platinov(II) bromid:PtBr2
platinov diklorid=platinov(II) klorid:PtCl2
platinov dicianid=platinov(II) cianid:Pt(CN)2
platinov dijodid=platinov(II) jodid:PtI2
renijev diklorid=renijev(III) klorid:ReCl3
renijev diklorid=renijev(V) klorid:ReCl5
renijev dioksid=renijev(VI) oksid:ReO3
direnijev heptaoksid=renijev(VII) oksid:Re2O7
renijev disulfid=renijev(IV) sulfid:ReS2
direnijev heptasulfid=renijev(VII) sulfid:Re2S7
rutenijv dioksid=rutenijv(IV) oksid:RuO2
antimonov diklorid=antimonov(V) klorid:SbCl5
antimonov difluorid=antimonov(V) fluorid:SbF5
diantimonov pentaoksid=antimonov(V) oksid:Sb2O5
diantimonov pentasulfid=antimonov(V) sulfid:Sb2S5
selenov dibromid=selenov(IV) bromid:SeBr4
selenov diklorid=selenov(IV) klorid:SeCl4
selenov dioksid=selenov(IV) oksid:SeO2
kositrov dijodid=kositrov(IV) jodid:SnI4
kositrov dibromid=kositrov(IV) bromid:SnBr4
kositrov diklorid=kositrov(IV) klorid:SnCl4
kositrov dioksid=kositrov(IV) oksid:SnO2
kositrov difluorid=kositrov(IV) fluorid:SnF4
telurjev dijodid=telurjev(IV) jodid:TeI4
telurjev dibromid=telurjev(IV) bromid:TeBr4
telurjev diklorid=telurjev(IV) klorid:TeCl4
telurjev dioksid=telurjev(IV) oksid:TeO2
talijev diklorid=talijev(III) klorid:TlCl3
ditalijev trioksid=talijev(III) oksid:Tl2O3
titanov diklorid=titanov(III) klorid:TiCl3
titanov(II) oksid:TiO
dititanov trioksid=titanov(III) oksid:Ti2O3
titanov difluorid=titanov(III) fluorid:TiF3
titanov dihidrid=titanov(II) hidrid:TiH2
titanov disulfid=titanov(VI) sulfid:TiS3
uranov dijodid=uranov(IV) jodid:UI4
vanadijev diklorid=vanadijev(IV) klorid:VCl4
vanadijev difluorid=vanadijev(IV) fluorid:VF4
vanadijev(II) oksid:VO
vanadijev dioksid=vanadijev(IV) oksid:VO2
divanadijev pentaoksid=vanadijev(V) oksid:V2O5
volframov dioksid=volframov(IV) oksid:WO2
volframov diselenid=volframov(IV) selenid:WSe2
volframov disulfid=volframov(IV) sulfid:WS2
+kislina
klorovodikova kislina:HCl
fluorovodikova kislina:HF
bromovodikova kislina:HBr
jodovodikova kislina:HI
žveplova(VI) kislina=žveplova kislina:H2SO4
žveplova(IV) kislina=žveplasta kislina:H2SO3
dušikova(V) kislina=dušikova kislina:HNO3
dušikova(III) kislina=dušikasta kislina:HNO2
fosforjeva(V) kislina=fosforjeva kislina:H3PO4
klorova(I) kislina=hipoklorasta kislina:HClO
klorova(III) kislina=klorasta kislina:HClO2
klorova(V) kislina=klorova kislina:HClO3
klorova(VII) kislina=perklorova kislina:HClO4
etanojska kislina=ocetna kislina:CH3COOH
metanojska kislina=mravljinčna kislina:HCOOH
ogljikova kislina=ogljikova(IV) kislina:H2CO3
+baza
natrijev hidroksid:NaOH
litijev hidroksid:LiOH
kalijev hidroksid:KOH
rubidijev hidroksid:RbOH
cezijev hidroksid:CsOH
barijev hidroksid:Ba(OH)2
magnezijev hidroksid:Mg(OH)2
kalcijev hidroksid:Ca(OH)2
stroncijev hidroksid:Sr(OH)2
aluminijev hidroksid:Al(OH)3
amoniak=amonijak:NH3
+solni_element
NH4:amonijev:1
Li:litijev:1
Na:natrijev:1
K:kalijev:1
Rb:rubidijev:1
Cs:cezijev:1
Mg:magnezijev:2
Ca:kalcijev:2
Sr:stroncijev:2
Ba:barijev:2
Al:aluminijev:3
CO3:karbonat=karbonat(IV):-2
SO4:sulfat=sulfat(VI):-2
SO3:sulfit=sulfat(IV):-2
PO4:fosfat=fosfat(V):-3
ClO4:perklorat=klorat(VII):-1
ClO3:klorat=klorat(V):-1
ClO2:klorit=klorat(III):-1
ClO:hipoklorit=klorat(I):-1
NO3:nitrat=nitrat(V):-1
NO2:nitrit=nitrat(III):-1
HCOO:metanoat=format:-1
CH3COO:etanoat=acetat:-1
+solna_izjema
srebrov(I) etanoat=srebrov(I) acetat:AgCH3COO
srebrov(I) karbonat=srebrov(I) karbonat(IV):Ag2CO3
srebrov(I) jodat=srebov(I) jodat(V):AgIO3
srebrov(I) nitrat=srebrov(I) nitrat(V):AgNO3
srebrov(I) perklorat=srebrov(I) klorat(VII):AgClO4
srebrov(I) fosfat=srebrov(I) fosfat(V):AgPO4
srebrov(I) sulfat=srebrov(I) sulfat(VI):Ag2SO4
srebrov(I) sulfit=srebrov(I) sulfat(IV):Ag2SO3
barijev bromat=barijev bromat=barijev(II) bromat(V)=barijev bromat(V):Ba(BrO3)2
barijev selenat(IV)=barijev selenit:BaSeO3
bizmutov(III) etanoat=bizmutov(III) acetat:Bi(CH3COO)3
bizmutov(III) fosfat=bizmutov(III) fosfat(V):BiPO4
kadmijev(II) bromat(V)=kadmijev(II) bromat:Cd(BrO3)2
kadmijev(II) karbonat=kadmijev(II) karbonat(IV):CdCO3
kadmijev(II) fosfat=kadmijev(II) fosfat(V):Cd3(PO4)2
kadmijev(II) sulfat=kadmijev(II) sulfat(VI):CdSO4
kobaltov(II) etanoat=kobaltov(II) acetat:Co(CH3COO)2
kobaltov(II) karbonat=kobaltov(II) karbonat(IV):CoCO3
kobaltov(II) fosfat=kobaltov(II) fosfat(V):Co3(PO4)2
kromov(III) sulfat=kromov(III) sulfat(VI):Cr2(SO4)3
bakrov(II) etanoat=bakrov(II) acetat:Cu(CH3COO)2
bakrov(II) jodat=bakrov(II) jodat(V):Cu(IO3)2
bakrov(II) nitrat=bakrov(II) nitrat(V):Cu(NO3)2
bakrov(II) fosfat=bakrov(II) fosfat(V):Cu3(PO4)2
bakrov(II) sulfat=bakrov(II) sulfat(VI):CuSO4
železov(II) etanoat=železov(II) acetat:Fe(CH3COO)2
železov(II) perklorat=železov(II) klorat(VII):Fe(ClO4)2
železov(III) perklorat=železov(III) klorat(VII):Fe(ClO4)2
železov(III) sulfat=železov(III) sulfat(VI):Fe2(SO4)3
galijev(III) nitrat=galijev(III) nitrat(V):Ga(NO3)3
galijev(III) sulfat=galijev(III) sulfat(VI):Ga2(SO4)3
galijev(III) perklorat=galijev(III) klorat(VII):Ga(ClO4)3
živosrebrov(II) etanoat=živosrebrov(II) acetat:Hg(CH3COO)2
živosrebrov(II) nitrat=živosrebrov(II) nitrat(V):Hg(NO3)2
živosrebrov(II) sulfat=živosrebrov(II) sulfat(VI):HgSO4
hafnijev(II) sulfat=hafnijev(II) sulfat(VI):Hf(SO4)2
indijev(III) etanoat=indijev(III) acetat:In(CH3COO)3
indijev(III) nitrat=indijev(III) nitrat(V):In(NO3)3
indijev(III) fosfat=indijev(III) fosfat(V):InPO4
indijev(III) sulfat=indijev(III) sulfat(VI):In2(SO4)3
lantanov(III) etanoat=lantanov(III) acetat:La(CH3COO)3
lantanov(III) karbonat=lantanov(III) karbonat(IV):La2(CO3)3
lantanov(III) fosfat=lantanov(III) fosfat(V):LaPO4
lantanov(III) sulfat=lantanov(III) sulfat(VI):La2(SO4)3
manganov(II) karbonat=manganov(II) karbonat(IV):MnCO3
manganov(II) nitrat=manganov(II) nitrat(V):Mn(NO3)2
nikljev(II) karbonat=nikljev(II) karbonat(IV):NiCO3
svinčev(IV) etanoat=svinčev(IV) acetat:Pb(CH3COO)4
svinčev(II) karbonat=svinčev(II) karbonat(IV):PbCO3
svinčev(II) nitrat=svinčev(II) nitrat(V):Pb(NO3)2
svinčev(II) selenat(IV)=svinčev(II) selenit:PbSeO3
svinčev(II) sulfat(VI)=svinčev(II) sulfat:PbSO4
paladijev(II) etanoat=paladijev(II) acetat:Pd(CH3COO)2
paladijev(II) nitrat=paladijev(II) nitrat(V):Pd(NO3)2
paladijev(II) sulfat=paladijev(II) sulfat(VI):PdSO4
rodijev(III) nitrat=rodijev(III) nitrat(V):Rh(NO3)3
rodijev(III) sulfat(VI)=rodijev(III) sulfat:Rh2(SO4)3
skandijev(III) etanoat=skandijev(III) acetat:Sc(CH3COO)3
skandijev(III) karbonat=skandijev(III) karbonat(IV):Sc2(CO3)3
skandijev(III) nitrat(V)=skandijev(III) nitrat:Sc(NO3)3
silicijev(IV) etanoat=silicijev(IV) acetat:Si(CH3COO)4
kositrov(II) etanoat=kositrov(II) acetat:Sn(CH3COO)2
kositrov(IV) etanoat=kositrov(IV) acetat:Sn(CH3COO)4
stroncijev jodat=stroncijev jodat(V):Sr(IO3)2
titanov(III) sulfat(VI)=titanov(III) sulfat:Ti2(SO4)3
talijev(I) etanoat=talijev(I) acetat:TlCH3COO
talijev(I) karbonat=talijev(I) karbonat(IV):Tl2CO3
talijev(I) nitrat=talijev(I) nitrat(V):TlNO3
talijev(III) nitrat(V)=talijev(III) nitrat:Tl(NO3)3
talijev(I) sulfat=talijev(I) sulfat(VI):Tl2SO4
itrijev(III) karbonat=itijev(III) karbonat(IV):Y2(CO3)3
itrijev(III) fosfat=itrijev(III) fosfat(V):YPO4
iterbijev(III) nitrat(V)=iterbijev(III) nitrat:Yb(NO3)3
cinkov(II) etanoat=cinkov(II) acetat:Zn(CH3COO)2
amonijev jodat=amonijev jodat(V):NH4IO3
+hidrogensolni_element
NH4:amonijev:1
Li:litijev:1
Na:natrijev:1
K:kalijev:1
Rb:rubidijev:1
Cs:cezijev:1
Mg:magnezijev:2
Ca:kalcijev:2
Sr:stroncijev:2
Ba:barijev:2
Al:aluminijev:3
HCO3:hidrogenkarbonat=hidrogenkarbonat(IV):-1
HS:hidrogensulfid:-1
HSO4:hidrogensulfat(VI)=hidrogensulfat:-1
HSO3:hidrogensulfit=hidrogensulfat(IV):-1
HPO4:hidrogenfosfat(V)=hidrogenfosfat:-2
H2PO4:dihidrogenfosfat(V)=dihidrogenfosfat:-1
+kristalohidrat
aluminijev klorid heksahidrat:AlCl3*6H20
aluminijev fluorid trihidrat:AlF3*3H2O
aluminijev nitrat nonahidrat=aluminijev nitrat(V) nonahidrat:Al(NO3)3*9H2O
aluminijev perklorat nonahidrat=aluminijev klorat(VII) nonahidrat:Al(ClO4)3*9H2O
barijev bromid dihidrat:BaBr2*2H2O
barijev klorid dihidrat:BaCl2*2H2O
barijev hidroksid oktahidrat:Ba(OH)2*8H2O
barijev perklorat trihidrat=barijev klorat(VII) trihidrat:Ba(ClO4)2*3H2O
bizmutov(III) nitrat(V) pentahidrat=bizmutov(III) nitrat pentahidrat:Bi(NO3)3*5H2O
kalcijev klorid dihidrat:CaCl2*2H2O
kalcijev hidrogenfosfat dihidrat=kalcijev hidrogenfosfat(V) dihidrat:CaHPO4*2H2O
kalcijev nitrat tetrahidrat=kalcijev nitrat(V) tetrahidrat:Ca(NO3)2*4H2O
kalcijev sulfat dihidrat=kalcijev sulfat(VI) dihidrat:CaSO4*2H2O
kadmijev(II) acetat dihidrat=kadmijev(II) etanoat dihidrat:Cd(CH3COO)2*2H2O
kadmijev(II) bromid dihidrat=kadmijev dibromid dihidrat:CdBr2*2H2O
kadmijev(II) nitrat tetrahidrat=kadmijev(II) nitrat(V) tetrahidrat:Cd(NO3)2*4H2O
kadmijev(II) perklorat heksahidrat=kadmijev(II) klorat(VII) heksahidrat:Cd(ClO4)2*6H2O
kobaltov(II) acetat tetrahidrat=kobaltov(II) etanoat tetrahidrat:Co(CH3COO)2*4H2O
kobaltov(II) klorid heksahidrat=kobaltov diklorid heksahidrat:CoCl2*6H2O
kobaltov(II) fluorid tetrahidrat=kobaltov difluorid tetrahidrat:CoF2*4H2O
kobaltov(II) jodid dihidrat=kobaltov dijodid dihidrat:CoI2*2H2O
kobaltov(II) nitrat heksahidrat=kobaltov(II) nitrat(V) heksahidrat:Co(NO3)2*6H2O
kobaltov(II) perklorat heksahidrat=kobaltov(II) klorat(VII) heksahidrat:Co(ClO4)2*6H2O
kobaltov(II) fosfat oktahidrat=kobaltov(II) fosfat(V) oktahidrat:Co3(PO4)2*8H2O
kobaltov(II) sulfat heptahidrat=kobaltov(II) sulfat(VI) heptahidrat:CoSO4*7H2O
kromov(III) bromid heksahidrat=kromov tribromid heksahidrat:CrBr3*6H2O
kromov(III) klorid heksahidrat=kromov triklorid heksahidrat:CrCl3*6H2O
kromov(III) nitrat nonahidrat=kromov(III) nitrat(V) nonahidrat:Cr(NO3)3*9H2O
kromov(III) perklorat heksahidrat=kromov(III) klorat(VII) heksahidrat:Cr(ClO4)3*6H2O
kromov(III) fosfat tetrahidrat=kromov(III) fosfat(V) tetrahidrat:CrPO4*4H2O
bakrov(II) acetat hidrat=bakrov(II) etanoat hidrat:Cu(CH3COO)2*H2O
bakrov(II) klorid dihidrat=bakrov diklorid dihidrat:CuCl2*2H2O
bakrov(II) fluorid dihidrat=bakrov difluorid dihidrat:CuF2*2H2O
bakrov(II) metanoat tetrahidrat=bakrov(II) format tetrahidrat:Cu(HCOO)2*4H2O
bakrov(II) klorat(VII) heksahidrat=bakrov(II) perklorat heksahidrat:Cu(ClO4)2*6H2O
bakrov(II) sulfat pentahidrat=bakrov(II) sulfat(VI) pentahidrat:CuSO4*5H2O
indijev(III) klorat(VII) oktahidrat=indijev perklorat oktahidrat:In(ClO4)3*8H2O
iridijev(IV) oksid dihidrat=iridijev dioksid dihidrat:IrO2*2H2O
kalijev fluorid dihidrat:KF*2H2O
lantanov(III) klorid heptahidrat=lantanov triklorid heptahidrat:LaCl3*7H2O
lantanov(III) nitrat heksahidrat=lantanov(III) nitrat(V) heksahidrat:La(NO3)3*6H2O
lantanov(III) klorat(VII) heksahidrat=lantanov(III) perklorat heksahidrat:La(ClO4)3*6H2O
litijev acetat dihidrat=litijev etanoat dihidrat:LiCH3COO*2H2O
litijev jodat(VII) dihidrat=litijev perjodat dihidrat:LiIO4*2H2O
magnezijev acetat tetrahidrat=magnezijev etanoat tetrahidrat:Mg(CH3COO)2*4H2O
magnezijev bromid heksahidrat:MgBr2*6H2O
magnezijev klorid heksahidrat:MgCl2*6H2O
magnezijev nitrat heksahidrat=magnezijev nitrat(V) heksahidrat:Mg(NO3)2*6H2O
magnezijev klorat(VII) heksahidrat=magnezijev perklorat heksahidrat:Mg(ClO4)2*6H2O
magnezijev fosfat pentahidrat=magnezijev fosfat(V) pentahidrat:Mg3(PO4)2*5H2O
magnezijev sulfat heptahidrat=magnezijev sulfat(VI) heptahidrat:MgSO4*7H2O
manganov(II) acetat tetrahidrat=manganov(II) etanoat tetrahidrat:Mn(CH3COO)2*4H2O
manganov(II) klorid tetrahidrat=manganov diklorid tetrahidrat:MnCl2*4H2O
manganov(II) fluorid dihidrat=manganov difluorid dihidrat:MnF2*2H2O
manganov(II) format dihidrat=manganov(II) metanoat dihidrat:Mn(HCOO)2*2H2O
manganov(II) jodid tetrahidrat=manganov dijodid tetrahidrat:MnI2*4H2O
manganov(II) nitrat tetrahidrat=manganov(II) nitrat(V) tetrahidrat:Mn(NO3)2*4H2O
manganov(II) klorat(VII) heksahidrat=manganov(II) perklorat heksahidrat:Mn(ClO4)2*6H2O
manganov(II) sulfat tetrahidrat=manganov(II) sulfat(VI) tetrahidrat:MnSO4*4H2O
molibdenov(IV) sulfid dihidrat:MoS2*2H2O
natrijev acetat trihidrat=natrijev etanoat trihidrat:NaCH3COO*3H2O
natrijev karbonat dekahidrat:Na2CO3*10H2O
natrijev dihidrogenfosfat dihidrat=natrijev dihidrogenfosfat(V) dihidrat:NaH2PO4*2H2O
natrijev hidrogenfosfat heptahidrat=natrijev hidrogenfosfat(V) heptahidrat:Na2HPO4*7H2O
natrijev fosfat dodekahidrat=natrijev fosfat(V) dodekahidrat:Na3PO4*12H2O
natrijev selenat(VI) dekahidrat:Na2SeO4*10H2O
natrijev sulfat dekahidrat=natrijev sulfat(VI) dekahidrat:Na2SO4*10H2O
natrijev sulfid nonahidrat:Na2S*9H2O
nikljev(II) acetat tetrahidrat=nikljev(II) etanoat tetrahidrat:Ni(CH3COO)2*4H2O
nikljev(II) bromid trihidrat=nikljev dibromid trihidrat:NiBr2*3H2O
nikljev(II) klorid heksahidrat=nikljev diklorid heksahidrat:NiCl2*6H2O
nikljev(II) cianid tetrahidrat:Ni(CN)2*4H2O
nikljev(II) fluorid tetrahidrat=nikljev difluorid tetrahidrat:NiF2*4H2O
nikljev(II) sulfat heksahidrat=nikljev(II) sulfat(VI) heksahidrat:NiSO4*6H2O
osmijev(III) klorid trihidrat=osmijev triklorid trihidrat:OsCl3*3H2O
svinčev(II) acetat trihidrat=svinčev(II) etanoat trihidrat:Pb(CH3COO)2*3H2O
svinčev(II) klorat(VII) trihidrat=svinčev(II) perklorat trihidrat:Pb(ClO4)2*3H2O
paladijev(II) sulfat dihidrat=paladijev(II) sulfat(VI) dihidrat:PdSO4*2H2O
rodijev(III) oksid pentahidrat=dirodijev trioksid pentahidrat:Rh2O3*5H2O
rodijev(III) sulfat tetrahidrat=rodijev(III) sulfat(VI) tetrahidrat:Rh2(SO4)3*4H2O
skandijev(III) klorid heksahidrat=skandijev triklorid heksahidrat:ScCl3*6H2O
skandijev(III) klorat(VII) heksahidrat=skandijev(III) perklorat heksahidrat:Sc(ClO4)3*6H2O
skandijev(III) sulfat heksahidrat=skandijev(III) sulfat(VI) heksahidrat:Sc2(SO4)3*6H2O
kositrov(II) klorid dihidrat=kositrov diklorid dihidrat:SnCl2*2H2O
stroncijev bromid heksahidrat:SrBr2*6H2O
stroncijev klorid heksahidrat:SrCl2*6H2O
stroncijev hidroksid oktahidrat:Sr(OH)2*8H2O
stroncijev klorat(VII) heksahidrat=stroncijev perklorat heksahidrat:Sr(ClO4)2*6H2O
talijev(III) nitrat(V) trihidrat=talijev(III) nitrat trihidrat:Tl(NO3)3*3H2O
itrijev(III) nitrat(V) heksahidrat=itrijev(III) nitrat heksahidrat:Y(NO3)3*6H2O
itrijev(III) klorat(VII) heksahidrat=itrijev(III) perklorat heksahidrat:Y(ClO4)3*6H2O
itrijev(III) sulfat oktahidrat=itrijev(III) sulfat(VI) oktahidrat:Y2(SO4)3*8H2O
itrijev(III) etanoat tetrahidrat=itrijev(III) acetat tetrahidrat:Y(CH3COO)3*4H2O
iterbijev(III) klorat(VII) heksahidrat=iterbijev(III) perklorat heksahidrat:Yb(ClO4)3*6H2O
iterbijev(III) sulfat oktahidrat=iterbijev(III) sulfat(VI) oktahidrat:Yb2(SO4)3*8H2O
cirkonijev(IV) sulfat tetrahidrat=cirkonijev(IV) sulfat(VI) tetrahidrat:Zr(SO4)2*4H2O
železov(II) klorid tetrahidrat=železov diklorid tetrahidrat:FeCl2*4H2O
železov(III) klorid heksahidrat=železov triklorid heksahidrat:FeCl3*6H2O
železov(III) fluorid trihidrat=železov trifluorid trihidrat:FeF3*3H2O
železov(III) nitrat nonahidrat=železov(III) nitrat(V) nonahidrat:Fe(NO3)3*9H2O
železov(II) sulfat heptahidrat=železov(II) sulfat(VI) heptahidrat:FeSO4*7H2O
živosrebrov(I) perklorat tetrahidrat=živosrebrov(I) klorat(VII) tetrahidrat:HgClO4*4H2O
živosrebrov(II) perklorat trihidrat=živosrebrov(II) klorat(VII) trihidrat:Hg(ClO4)2*3H2O
živosrebrov(II) perklorat heksahidrat=živosrebrov(II) klorat(VII) heksahidrat:Fe(ClO4)2*6H2O
cinkov(II) acetat dihidrat=cinkov(II) etanoat dihidrat:Zn(CH3COO)2*2H2O
cinkov(II) fluorid tetrahidrat=cinkov difluorid tetrahidrat:ZnF2*4H2O
cinkov(II) metanoat dihidrat=cinkov(II) format dihidrat:Zn(HCOO)2*2H2O
cinkov(II) nitrat heksahidrat=cinkov(II) nitrat(V) heksahidrat:Zn(NO3)2*6H2O
cinkov(II) klorat(VII) heksahidrat=cinkov(II) perklorat heksahidrat:Zn(ClO4)2*6H2O
cinkov(II) sulfit dihidrat=cinkov(II) sulfat(IV) dihidrat:ZnSO3*2H2O
cinkov(II) sulfat heptahidrat=cinkov(II) sulfat(VI) heptahidrat:ZnSO4*7H2O
